#############
#S          #
### # # ### #
#   # # #   #
# ### ### ###
#     #     #
##### # #####
#   # #   ###
# ### ###   #
#     #   E #
#############

