###############################
#S                            #
########### # ####### # # ### #
#     #     #       #   # #   #
# ##### ########### ##### # # #
# #   #           # #     # # #
# # # ########### # # ##### # #
# # #   #       # # #   # # # #
# # # # ### ##### # ### # # ###
#   # # #   #     #       #   #
# ### # # ### ############### #
# #   # #   # #     #         #
### ### ### # # ### # #########
#   # #   # # # #   #   #     #
# ### ### # # # # ##### # ### #
#   #       #   #     #   #   #
# # ################# ##### # #
# #       #       #   #     # #
# ####### # ### ### ### ### ###
#       #     #         #    E#
###############################