####################
##### E ############
#####   ############
#####       ########
########    ########
########  S ########